+-+-+-+-+-+-+-+-+-+-+-+-+-+-+-+-+-+-+-+-+-+-+-+-+-+-+-+
############|   |       |#####|#######|       |   |   |
+-+-+-+-+-+#+-+ + +-+-+ +#+-+#+#+-+ +#+ +-+-+ + + +-+ +
|#####|    #|   | |     |#|###|#| | |#|   |     |     |
+#+ +#+-+-+#+ +-+ + +-+-+#+#+-+#+ + +#+-+-+ +-+-+ + +-+
|#| |#|#####|   | | |   |#|#|###|   |#####  |     |   |
+#+-+#+#+-+-+-+ + + +-+ +#+#+#+-+-+-+-+-+#+-+ +-+-+ +-+
|#|###|###|  ###| |   | |#|#|#|  #########|   |   |   |
+#+#+-+ +#+-+#+#+ +-+ + +#+#+#+ +#+-+-+-+-+ +-+-+ +-+-+
|#|###| |#|###|#| |   | |#|###| |#|   |           |   |
+#+-+#+-+#+#+-+#+-+ +-+ +#+-+-+ +#+ +-+ +-+ +-+-+-+ +-+
|###|#####|###|#########|#|     |#|     | | |   | |   |
+-+#+-+-+-+-+#+-+-+ +-+#+#+ +-+-+#+-+-+-+ + + + + + +-+
|  #########|#|   |   |###|   |###|###|   |   | | |   |
+ +-+-+ +-+#+#+ + +-+ +-+-+-+ +#+-+#+#+ +-+-+ + + +-+ +
| | |     |#|#  | |   |       |#|###|#|       |   |   |
+ + + +-+ +#+#+-+ + +-+-+-+-+-+#+#+ +#+-+-+-+-+-+-+-+-+
| | | |   |#|#| |       |     |#|#| |#######|     |   |
+ + + + +-+#+#+ +-+ +-+ + +-+ +#+#+-+-+-+-+#+ +-+ + +-+
|   | |   |###|   | |   |   | |###|     |### ###| |   |
+-+-+ +-+ +-+-+-+ +-+ +-+-+-+ +-+-+ +-+ +#+-+#+#+-+-+ +
|   |   | |     |     |     | |   |   | |###|#|###|   |
+ + +-+-+ + +-+ +-+ +-+-+-+ + +-+ +-+-+ +-+#+#+-+#+-+-+
|         |   |     |   |     |     |   |  ###|  ######
+-+-+-+-+-+-+-+-+-+-+-+-+-+-+-+-+-+-+-+-+-+-+-+-+-+-+-+
