+-+-+-+-+-+-+-+-+-+-+-+-+-+-+-+-+-+-+-+-+-+-+-+-+-+
############|   |       |#####|#######|       |   |
+-+-+-+-+-+#+-+ + +-+-+ +#+-+#+#+-+ +#+ +-+-+ + + +
|#####|    #|   | |     |#|###|#| | |#|   |     | |
+#+ +#+-+-+#+ +-+ + +-+-+#+#+-+#+ + +#+-+-+ +-+-+ +
|#| |#|#####|   | | |   |#|#|###|   |#####  |     |
+#+-+#+#+-+-+-+ + + +-+ +#+#+#+-+-+-+-+-+#+-+ +-+-+
|#|###|###|  ###| |   | |#|#|#|  #########|   |   |
+#+#+-+ +#+-+#+#+ +-+ + +#+#+#+ +#+-+-+-+-+ +-+-+ +
|#|###| |#|###|#| |   | |#|###| |#|   |           |
+#+-+#+-+#+#+-+#+-+ +-+ +#+-+-+ +#+ +-+ +-+ +-+-+-+
|###|#####|###|#########|#|     |#|     | | |   | |
+-+#+-+-+-+-+#+-+-+ +-+#+#+ +-+-+#+-+-+-+ + + + + +
|  #########|#|   |   |###|   |###|###|   |   | | |
+ +-+-+ +-+#+#+ + +-+ +-+-+-+ +#+-+#+#+ +-+-+ + + +
| | |     |#|#  | |   |       |#|###|#|       |   |
+ + + +-+ +#+#+-+ + +-+-+-+-+-+#+#+ +#+-+-+-+-+-+-+
| | | |   |#|#| |       |     |#|#| |#######|     |
+ + + + +-+#+#+ +-+ +-+ + +-+ +#+#+-+-+-+-+#+ +-+ +
|   | |   |###|   | |   |   | |###|     |### ###| |
+-+-+ +-+ +-+-+-+ +-+ +-+-+-+ +-+-+ +-+ +#+-+#+#+-+
|   |   | |     |     |     | |   |   | |###|#|###|
+ + +-+-+ + +-+ +-+ +-+-+-+ + +-+ +-+-+ +-+#+#+-+#+
|         |   |     |   |     |     |   |  ###|  ##
+-+-+-+-+-+-+-+-+-+-+-+-+-+-+-+-+-+-+-+-+-+-+-+-+-+
