+-+-+-+-+-+-+-+-+-+-+-+-+-+-+-+-+-+-+-+-+-+-+-+-+-+
############|   |       |#####|#######|       |   |
+-+-+-+-+-+#+-+ + +-+-+ +#+-+#+#+-+ +#+ +-+-+ + + +
|#####|    #|   | |     |#|###|#| | |#|   |     | |
+#+ +#+-+-+#+ +-+ + +-+-+#+#+-+#+ + +#+-+-+ +-+-+ +
|#| |#|#####|   | | |   |#|#|###|   |#####  |     |
+#+-+#+#+-+-+-+ + + +-+ +#+#+#+-+-+-+-+-+#+-+ +-+-+
|#|###|###|  ###| |   | |#|#|#|  #########|   |   |
+#+#+-+ +#+-+#+#+ +-+ + +#+#+#+ +#+-+-+-+-+ +-+-+ +
|#|###| |#|###|#| |   | |#|###| |#|   |           |
+#+-+#+-+#+#+-+#+-+ +-+ +#+-+-+ +#+ +-+ +-+ +-+-+-+
|###|#####|###|#########|#|     |#|     | | |   | |
+-+#+-+-+-+-+#+-+-+ +-+#+#+ +-+-+#+-+-+-+ + + + + +
|  #########|#|   |   |###|   |###|###|   |   | | |
+ +-+-+ +-+#+#+ + +-+ +-+-+-+ +#+-+#+#+ +-+-+ + + +
| | |     |#|#  | |   |       |#|###|#|       |   |
+ + + +-+ +#+#+-+ + +-+-+-+-+-+#+#+ +#+-+-+-+-+-+-+
| | | |   |#|#| |       |     |#|#| |#######|     |
+ + + + +-+#+#+ +-+ +-+ + +-+ +#+#+-+-+-+-+#+ +-+ +
|   | |   |###|   | |   |   | |###|     |  #####| |
+-+-+ +-+ +-+-+-+ +-+ +-+-+-+ +-+ + +-+ + +-+ +#+-+
|   |   | |     |     |     | |   |   | |   | |###|
+ + +-+-+ + +-+ +-+ +-+-+-+ + +-+ +-+-+ +-+-+ +-+#+
|         |   |     |   |     |                 |##
+-+-+-+-+-+-+-+-+-+-+-+-+-+-+-+-+-+-+-+-+-+-+-+-+-+
