+-+-+-+-+-+-+-+-+-+-+-+-+-+-+-+-+-+-+-+-+-+-+-+-+-+-+-+
            |   |       |     |       |       |   |   |
+-+-+-+-+-+ +-+ + +-+-+ + +-+ + +-+ + + +-+-+ + + +-+ +
|     |     |   | |     | |   | | | | |   |     |     |
+ + + +-+-+ + +-+ + +-+-+ + +-+ + + + +-+-+ +-+-+ + +-+
| | | |     |   | | |   | | |   |   |       |     |   |
+ +-+ + +-+-+-+ + + +-+ + + + +-+-+-+-+-+ +-+ +-+-+ +-+
| |   |   |     | |   | | | | |           |   |   |   |
+ + +-+ + +-+ + + +-+ + + + + + + +-+-+-+-+ +-+-+ +-+-+
| |   | | |   | | |   | | |   | | |   |           |   |
+ +-+ +-+ + +-+ +-+ +-+ + +-+-+ + + +-+ +-+ +-+-+-+ +-+
|   |     |   |         | |     | |     | | |   | |   |
+-+ +-+-+-+-+ +-+-+ +-+ + + +-+-+ +-+-+-+ + + + + + +-+
|           | |   |   |   |   |   |   |   |   | | |   |
+ +-+-+ +-+ + + + +-+ +-+-+-+ + +-+ + + +-+-+ + + +-+ +
| | |     | |   | |   |       | |   | |       |   |   |
+ + + +-+ + + +-+ + +-+-+-+-+-+ + + + +-+-+-+-+-+-+-+-+
| | | |   | | | |       |     | | | |       |     |   |
+ + + + +-+ + + +-+ +-+ + +-+ + + +-+-+-+-+ + +-+ + +-+
|   | |   |   |   | |   |   | |   |     |       | |   |
+-+-+ +-+ +-+-+-+ +-+ +-+-+-+ +-+-+ +-+ + +-+ + +-+-+ +
|   |   | |     |     |     | |   |   | |   | |   |   |
+ + +-+-+ + +-+ +-+ +-+-+-+ + +-+ +-+-+ +-+ + +-+ +-+-+
|         |   |     |   |     |     |   |     |        
+-+-+-+-+-+-+-+-+-+-+-+-+-+-+-+-+-+-+-+-+-+-+-+-+-+-+-+
